Y = 7
X = 7
#######
#   @ #
#     #
##    #
#    ##
#     #
#######